@@@@@@@@@@@@@@@@@@@@@@@@
@@@@@@@@@@@@@@@@@@@@@@@@
@@@@@@@@@@@@@@@@@@@@@@@@
@@@@@@@@@@@@@@@@@@@@@@@@@@@@@0
@@@@@@@@@@@@@@@@@@@@@@@@@@@@@q
@@@@@@@@@@@@@@@@@@@@@@^@@@@@@@
@$@@@@@@@@@@@@@@@@@@@@qqq@@@@@
qqq@@@@@@@@@@@@@@@@!@@(**qq@?@
**)qqq@@@^^@@@@@!@@@@@(*)**qqq
**)**)qqqqq@@!@@@@@@@@(*)*)***
**)**)****)%@@@@@@@@@@(*)*)***
**qqqqq****q@@@@@@@@@@(*)*)***
**(***)****)@@@@@@@@@@(*)*)***
**(***)****)&&&&&&&&&&(*)*)***
**(***)****)wwwwwwwwww(*)*)***